5 53
.................................C......#############
................................####..........#######
.......C............##..........####..####...........
.S..E..##..E..##.C..######.C.E........#####....E...C.
#####################################################
