5 64
..................##...........................................#
...............................................................#
...............................................................#
.S..E..##.E.##.C..######.C.....................................#
################################################################