5 64
................................................................
................................................................
................................................................
..............................S.................................
################################################################